AIRTABLE FIELD CREATION INSTRUCTIONS
====================================

CREATE THESE 6 FIELDS IN YOUR AIRTABLE BASE:

1. PMS Used
   Type: Single select
   Options: Hostfully, Guesty, Lodgify, BookingSync, OwnerRez, Streamline, Hostaway, YourPorter, Avantio, RentalNinja, Kigo, RemoteLock, Tokeet, Bookerville, LiveRez, iGMS, Mynd, RedAwning, Rental United, CiiRUS, Track, RMS Cloud, Cloudbeds, BookingBoss, VRScheduler, Smartbnb, PriceLabs, Beyond Pricing, Wheelhouse, AirDNA, Key Data Dashboard, Transparent, Rented, Property Meld, Breezeway, TurnoverBnB, Properly, TIDY, Jetstream, FantasticStay, Red, Guest, TouchStay, Hostco, DPGO, StayFi, GuestTek, NoiseAware, Minut, Party Squasher, Alertify, August, Schlage, Yale, Lynx, PointCentral, SALTO, Nest, Ecobee, Honeywell, Ring, SimpliSafe, ADT, Kangaroo, Airbnb, VRBO, Booking.com, Expedia, HomeAway, TripAdvisor, FlipKey, RedWeek, Other, Custom Solution, No PMS

2. Min Price (ADR)
   Type: Number
   Format: Allow 2 decimal places

3. Max Price (ADR)
   Type: Number
   Format: Allow 2 decimal places

4. Currency
   Type: Single select
   139 Options:
   AED – د.إ
   AFN – ؋
   ALL – Lek
   AMD – ֏
   AOA – Kz
   ARS – AR$
   AUD – AU$
   AWG – AWƒ
   AZN – ₼
   BAM – KM
   BBD – BB$
   BDT – ৳
   BGN – лв
   BHD – ب.د
   BIF – FBu
   BMD – BM$
   BND – BN$
   BOB – Bs
   BRL – R$
   BSD – BS$
   BTN – Nu
   BYN – Br
   CAD – CA$
   CDF – FCF
   CHF – CHFr
   CLP – CL$
   CNY – CN¥
   COP – CO$
   CRC – ₡
   CUP – CU$
   CZK – Kč
   DJF – Fdj
   DKK – kr
   DOP – RD$
   DZD – د.ج
   EGP – LE
   ERN – Nkf
   ETB – Br
   EUR – €
   FJD – FJ$
   GBP – £
   GEL – ₾
   GHS – ₵
   GIP – GI£
   GMD – D
   GNF – FG
   GTQ – Q
   HKD – HK$
   HNL – L
   HRK – kn
   HUF – Ft
   IDR – Rp
   ILS – ₪
   INR – ₹
   IQD – ع.د
   IRR – ﷼
   ISK – kr
   JMD – JM$
   JOD – د.ا
   JPY – JP¥
   KES – KSh
   KGS – с
   KHR – ៛
   KMF – FC
   KRW – ₩
   KWD – ك
   KYD – KY$
   KZT – ₸
   LAK – ₭
   LBP – ل.ل
   LKR – රු
   LSL – L
   MAD – د.م
   MDL – L
   MGA – Ar
   MKD – ден
   MMK – K
   MNT – ₮
   MOP – MOP$
   MRU – UM
   MUR – MURs
   MVR – Rf
   MWK – MK
   MXN – MX$
   MYR – RM
   MZN – MT
   NAD – NA$
   NGN – ₦
   NIO – NI$
   NOK – kr
   NPR – ₨
   NZD – NZ$
   OMR – ر.ع
   PAB – B/.
   PEN – S/.
   PGK – K
   PHP – ₱
   PKR – ₨
   PLN – zł
   PYG – ₲
   QAR – ر.ق
   RON – lei
   RSD – RSD
   RUB – ₽
   RWF – FRw
   SAR – ﷼
   SCR – SCRs
   SDG – ج.س
   SEK – kr
   SGD – SG$
   SHP – SH£
   SLE – Le
   SRD – SR$
   STN – Db
   SVC – ₡
   SYP – SY£
   THB – ฿
   TJS – ЅМ
   TMT – T
   TND – د.ت
   TOP – T$
   TRY – ₺
   TTD – TT$
   TWD – NT$
   TZS – TSh
   UAH – ₴
   UGX – USh
   USD – US$
   UYU – UY$
   UZS – soʻm
   VES – Bs.S
   VND – ₫
   XAF – FCFA
   XCD – EC$
   XOF – CFA
   XPF – CFP₣
   YER – ﷼
   ZAR – R
   ZMW – ZK

5. Google Reviews Link
   Type: URL

6. Cancellation Policy
   Type: Single select
   Options:
   Flexible - Free cancellation up to 24 hours before check-in
   Moderate - Free cancellation up to 5 days before check-in
   Strict - Free cancellation up to 14 days before check-in
   Super Strict - 50% refund up to 30 days before check-in
   Non-refundable - No refunds allowed

NEXT STEPS:
1. Go to your Airtable base
2. Create these 6 fields manually
3. Copy/paste the options exactly as shown above
4. Let me know when complete - I'll update the frontend code